111111111111111111111111111111111
1E0000000000000000000000000000001
111110111111111110111111111111111
100000100000000000000000000000001
101111111111111111011111111111111
100000000000000000010000000000001
111111011111111111110111111111111
1000000100000N0000000000000000001
111111111111111111111111111111111